COMPRCOMPUTER PRGRAMMER  
COMTCCOMPUTER TECHNICIAN 
COMSCCOMPUTER SIENCE     
BUSSTBUSINESS            
MARKTMARKETING           
ACCTGACCOUNTING          
CSTABXXXXXXXXXXXXXXXXXXXX
CSTDEXXXXXXXXXXXXXXXXXXX
cSTFGXXXXXXXXXXXXXXXXXXX
CSTHIXXXXXXXXXXXXXXXXXXX
CSTJKXXXXXXXXXXXXXXXXXXX
CSTLMXXXXXXXXXXXXXXXXXXX
CSTNOXXXXXXXXXXXXXXXXXXX
CSTPRXXXXXXXXXXXXXXXXXXX
CSTQSXXXXXXXXXXXXXXXXXXX
CSTTUXXXXXXXXXXXXXXXXXXX
CSTVWXXXXXXXXXXXXXXXXXXX
CSTXYXXXXXXXXXXXXXXXXXXX